1111111111111111111
1000000C00100000001
1P000000001C0001001
10000000000000CE101
10000100C0000001101
1000010C00000000001
1111111111111111111