1111111111111111111
11000000C0000000001
1P000000000C0001001
110000000000000E101
1111111111111111111