1111111111111111111
1000010C00100000E01
1P000111001C0000001
10000000000000C0101
10000100C0000011111
100C010000000000001
1111111111111111111