1111111111111111111
11000000C0000000001
1P000000000C0001001
110000000000000E101
1100000000000000101
1100000000000000101
1100000000000000101
1100000000000000101
1100000000000000101
1100000000000000101
1100000000000000101
1100000000000000101
1100000000000000101
1100000000000000101
1111111111111111111