11111111111111111111
10010001000000P00001
1000E001000000000001
1000000000C000001111
10000000000000000001
11111111111111111111